 **************
          *****
** ******    **
**      **** **
******* **** **
        *    **
 ******** *****
        * *****
******* *      
*       ****** 
